Azerbaijan	AZ
Bahrain	BH
Belarus	BY
China	CN
Cuba	CU
Djibouti	DJ
Egypt	EG
Equatorial Guinea	GQ
Eritrea	ER
Ethiopia	ET
Iran	IR
Kazakhstan	KZ
Laos	LA
Libya	LY
Myanmar	MM
North Korea	KP
Pakistan	PK
Russia	RU
Saudi Arabia	SA
Somalia	SO
Sudan	SD
Syria	SY
Thailand	TH
Turkey	TR
Turkmenistan	TM
United Arab Emirates	AE
Uzbekistan	UZ
Venezuela	VE
Vietnam	VN
Yemen	YE
