Azerbaijan	AZ
Bahrain	BH
Belarus	BY
Burundi	BI
Cuba	CU
Djibouti	DJ
Egypt	EG
Equatorial Guinea	GQ
Eritrea	ER
Ethiopia	ET
India	IN
Iran	IR
Iraq	IQ
Kazakhstan	KZ
Laos	LA
Libya	LY
Myanmar	MM
Pakistan	PK
Russia	RU
Rwanda	RW
Saudi Arabia	SA
Singapore	SG
Somalia	SO
Sudan	SD
Syria	SY
Tajikistan	TJ
Thailand	TH
Turkey	TR
Turkmenistan	TM
Uganda	UG
United Arab Emirates	AE
Uzbekistan	UZ
Venezuela	VE
Vietnam	VN
Yemen	YE
